+-----------------------------+
| O       c                   |
| # # # #c#c# # # # # # # #c# |
|    c    c    @     c        |
| #c# # # #c# # # # #c# # #c#c|
|       @      c     c   @    |
| #c#c#c#c#c# # #c# # # #c# # |
|c           c  @  c     c    |
| # #c# #c# # # # # #c# # # # |
|c     @ c   c     @ c     c@ |
| # #c# #c# #c# #c# # # # # #c|
|  c           @         c    |
| # # # # #c# # # # #c# # # #c|
|    c @   c      @    c      |
+-----------------------------+